11111111
2222222222
33333333
4444
