11111111
11P1E001
11100001
10000001
10000001
10000C01
11111111
