11111111
10C1E001
10010011
100P0001
11111111
