1111111111111111111111111111111111111111
1000000000000000000000000000000000001001
1011111111111111111111111111111111101001
1000000000000000000000000000000000101001
1011111111111111111111111111111111101001
1000000000000000000000000C00000000101001
1011111111111111111111111111111111101001
10000000000000000000000E0000000000101001
1011111111111111111111111111111111101001
1000000000000000000000000000000000101001
1011111111111111111111111111111111101001
1000000000000000000000000000000000101001
1011111111111111111111111111111111101001
1000000000000000000000000000000000101001
1011111111111111111111111111111111110001
1000000000000000000000000000000000100101
1011111111111111111111111111111111100001
1000000000000000000000000000000000001001
1011111111111111111111111111111111111111
1000000000000000000000000000000000000001
1000000000000000000000000000000000101001
1011111111111111111111111111111111101001
1000000000000000000000000000000000101001
1011111111111111111111111111111111101001
1000000000000000000000000000000000101001
1011111111111111111111111111111111101001
10000000000000P0000000000000C00000101001
1011111111111111111111111111111111101001
1000000000000000000000000000000000101001
1011111111111111111111111111111111101001
1000000000000000000000000000000000101001
1011111111111111111111111111111111101001
1000000000000000000000000000000000000001
1000000000000000000000000000000000000001
1000000000000000000000000000000000000001
1000000000000000000000000000000000000001
1000000000000000000000000000000000000001
1111111111111111111111111111111111111111
