11111111
11P0E001
11100001
10000001
10000001
10000C01
11111111
