1111111111111111111111111111111111
10000000000000000000000P0000000001
1000101010000000000000000000000001
1000000000000C00000000000000E00001
1000100010000000000001000000000001
10000000000000000C1111000000000001
100010101C000000000000000000000001
10000000000000C0001111000000000001
1000000C00000000000000001110000001
1000000000000000000000000000000001
1111111111111111111111111111111111
