11111111
10C1E001
10010011
10P00001
11111111
